10000000000000000000000000000001000
01000000000000000000000000000010000
00100000000000000000000000000100000
00010000000000000000000000001000000
00001000000000000000000000010000000
00000100000000000000000000100000000
00000010000000000000000001000000000
00000001000000000000000010000000000
00000000100000000000000100000000000
00000000010000000000001000000000000
00000000001000000000010000000000000
00000000000100000000100000000000000
00000000000010000001000000000000000
00000000000001111110000000000000000
00000000000001111110000000000000000
00000000000001100110000000000000000
00000000000001100110000000000000000
00000000000001111110000000000000000
00000000000001111110000000000000000
00000000000010010001000000000000000
00000000000100100000100000000000000
00000000001001000000010000000000000
00000000010010000000001000000000000
00000000100100000000000100000000000
00000001001000000000000010000000000
00000010010000000000000001000000000
00000100100000000000000000100000000
00001001000000000000000000010000000
00010010000000000000000000001000000
00000100000000000000000000000100000
00001000000000000000000000000010000
00010000000000000000000000000001000
00100000000000000000000000000000100
01000000000000000000000000000000010
10000000000000000000000000000000001